NO ./assets/textures/north_texture.xpm
EA ./assets/textures/east_texture.xpm
SO ./assets/textures/south_texture.xpm
WE ./assets/textures/west_texture.xpm

F 0,100,0
C 0,110,170

11111111111111
10000000000001
100000N0000001
10000000000001
11111111111001111111111
11111111111000000000011
11111111111000000000001
11111111111000000000001
11111111111000000000001
11111111111000000000001
11111111111000000000001
11111111111111111111111