NO ./assets/textures/north_texture.xpm
EA ./assets/textures/east_texture.xpm
SO ./assets/textures/south_texture.xpm
WE ./assets/textures/west_texture.xpm

F 220,100,0
C 225,30,0

1111111111111111111111111
1100000000110000000000001
01100001110000000000001
11010000000000000000000011111
111111111011000001110000000000001
100000000011000001110111111111111
111101111111110111000000100010000
1111011111111011101010010001
1100000011010101010000010001
100000000000000011000S00010001
100000000000000011010101001
1100000111010101111101111000111
11110111 1110101 101111010001
11111111 1111111 111111111111