NO ./assets/textures/N.xpm
EA ./assets/textures/E.xpm
SO ./assets/textures/S.xpm
WE ./assets/textures/W.xpm

F 0,100,0
C 0,110,170

1111111111111111111111111
110000000011000000000001
011000011100000000000011
11010000000000000000000111111111
11111111101100001110000000000001
100000000011000001110111111111111
111101111111110111000000100100001
111101111111101110101001000111111
11000000110101010100000100011
100000000000000011000S00010011
1000000000000001101010100111
1100000111010101111101111000111
11110111 1110101 101111010001
11111111 1111111 111111111111