NO ./assets/textures/north_texture.xpm
EA ./assets/textures/east_texture.xpm
SO ./assets/textures/south_texture.xpm
WE ./assets/textures/west_texture.xpm

F 220,100,0
C 225,30,0

1111111111111111111111111
11000000001100000000000
011000011100000000000011
11010000000000000000000011111111
11111111101100001110000000000001
100000000011000001110111111111111
111101111111110111000000100100001
111101111111101110101001000111111
11000000110101010100000100011
100000000000000011000S00010001
10000000000000001101010100111
1100000111010101111101111000111
11110111 1110101 101111010001
11111111 1111111 111111111111