NO ./assets/textures/north_texture.xpm
EA ./assets/textures/east_texture.xpm
SO ./assets/textures/south_texture.xpm
WE ./assets/textures/west_texture.xpm

F 0,100,0
C 0,110,170

1111
11N1
1111